1111111111G
1111111111G
BGGGGGGGB1G
G1111111G1G
G1BGGGB1G1G
G1G111G1G1G
G1G1BRB1G1G
G1G1G111G1G
G1G1BGGGB1G
G1G1111111G
G1BGGGGGGGB
G1111111111
G1111111111

1111111111V
11111111111
11111111111
11111111111
11111111111
11111111111
11111111111
11111111111
11111111111
11111111111
11111111111
11111111111
N1111111111

1111 1:
1001 00
0001 00