1111111111111
1BGGGGRGGGGB1
111111G111111
111111G111111
111111G111111
111111G111111
111111B111111
1111111111111

1111111111111
1S111111111S1
1111111111111
1111111111111
1111111111111
1111111111111
111111P111111
1111111111111

1111    16
1000    00
1010    00