11111G11111
11111G11111
11111G11111
11111G11111
11111G11111
GGGGGBGGGGG
11111G11111
11111G11111
11111G11111
11111G11111
11111G11111

11111V11111
11111111111
11111111111
11111111111
11111111111
V111111111V
11111111111
11111111111
11111111111
11111111111
11111N11111

1111 14
1101 14
0001 00