1RRRRRRRRR1
RRBBRRRBBRR
RB11BRB11BR
RB111G111BR
RRB11111BRR
RRRB111BRRR
11RRB1BRR11
111RRBRR111
111RRRRR111

11111111111
11VV111VV11
1V11V1V11V1
1V111V111V1
11V11111V11
111V111V111
1111V1V1111
11111V11111
11111N11111

1111 16
1101 13
0001 00