1111B1111
1111G1111
1111B1111
1111B1111
BGBBRBBGB
1111B1111
1111B1111
1111G1111
1111B1111

1111V1111
111111111
111111111
111111111
V111S111V
111111111
111111111
111111111
1111V1111

1111 14
1101 14
0001 00