GBBBBBBBBBBBBR
GBBBBBBBBBBB11
GBBBBBBBBBBR11
GBBBBBBBBBR111
GBBBBBBBBR1111
GBBBBBBBR11111
GBBBBBBR111111
GBBBBBR1111111
GBBBBR11111111
GBBBR111111111
GBBR1111111111
GBR11111111111

VVVVVVVVVVVVV1
VVVVVVVVVVVV11
VVVVVVVVVVV111
VVVVVVVVVV1111
VVVVVVVVV11111
VVVVVVVV111111
VVVVVVV1111111
VVVVVV11111111
VVVVV111111111
VVVV1111111111
VVV11111111111
VW111111111111

1111 15
1101 15
0001 00
