RRRR
RRRR
RRRR
RRRR

VVVV
VVVV
VVEV
VVVV

1111 15
1101 13
0101 00