11111111RR
1111111RR1
111111RR11
11111RR111
1111RR1111
111RR11111
11RR111111
1RR1111111
RR11111111

111111111V
1111111111
1111111111
1111111111
1111111111
1111111111
1111111111
1111111111
E111111111

1111 15
1000 00
0000 00