BGGGGRGGGGB
11111G11111
11111G11111
11111G11111
11111G11111
11111B11111

V111111111V
11111111111
11111111111
11111111111
11111111111
11111N11111

1111 16
1000 00
0100 00