111111G
111111R
111111R
111111R
111111R
BRRRRRB
111111R
111111R
111111R
111111R
111111G

111111V
1111111
1111111
1111111
1111111
N111111
1111111
1111111
1111111
1111111
111111V

1111 13
1100 14
1000 00