R1
R1
R1
R1
G1
G1
G1
G1
G1
G1
G1
G1
RG

S1
11
11
11
11
11
11
11
11
11
11
11
1V

1111 13
1101 13
0001 00