GBBGBBBRG
B11B111B1
B11B111B1
B11B111B1
B11B111B1
B11B111B1
B11B111B1
GBBGBBBR1

1V1E1V11V
111111111
111111111
V11V111V1
V11V111V1
111111111
111111111
1V1111V11

1111 16
1001 00
0111 00