BBBBB
BGBGB
BBGBB
BGBGB
BBBBB

VVVVV
V1V1V
VVEVV
V1V1V
VVVVV

1111 14
1000 00
0000 00