GBRGBRGBRGRBGRBG

V111111E1111111V

1111 15
1001 00
1111 00