1111R1111
1111B1111
1111B1111
1111B1111
RBBBBBBBR
1111B1111
1111B1111
1111B1111
1111R1111

1111V1111
1111V1111
1111V1111
1111V1111
VVVVWVVVV
1111V1111
1111V1111
1111V1111
1111V1111

1111 12
1101 15
0101 00