R111111111111
RRRRRRRRRRRRG

V111111111111
E11111111111V

1111 13
1101 15
0001 00