VVVVVVVVVVVVV1
VVVVVVVVVVVV11
VVVVVVVVVVV111
VVVVVVVVVV1111
VVVVVVVVV11111
VVVVVVVV111111
VVVVVVV1111111
VVVVVV11111111
VVVVV111111111
VVVV1111111111
VVV11111111111
VW111111111111
